NO assets/textures/mossy.png
SO assets/textures/redbrick.png
WE assets/textures/wood.png
EA assets/textures/eagle.png
F 20,20,20
C 200,200,200

11111
10S01
11111

1
