NO assets/textures/greystone.png
SO assets/textures/purplestone.png
WE assets/textures/redbrick.png
EA assets/textures/wood.png

F 18,53,25
C 153,204,255

111111111111
1       1111
1       0001
100000010011
10000000N001
111111111111
11         1
111111111111
