NO assets/textures/wood.png
SO assets/textures/redbrick.png
WE assets/textures/mossy.png
EA assets/textures/purplestone.png
F 220,100,0
C 33,30,200

111111
100001
100001
000001
1N0001
111111
