NO assets/textures/wood.png
SO assets/textures/redbrick.png
WE assets/textures/mossy.png
EA assets/textures/purplestone.png
F 220,100,0
C 33,30,200
 111111111111
1000000000001
10000N0000001
1111111111111





